8888888888
8000000008
8000000008
8000000008
8000000008
8000000008
8000000008
8000000008
8000000008
8000000008
8898888888
