88888888888888888
80000000000800008
80000000000800008
80000000000800008
80000008888800008
88888880000000008
80000000000000008
80000000000000008
80000000000000008
88888880000000008
80000000080000008
80000000080000008
80000000080000008
80000000080000008
80000000080000008
88988888888888888
