8888889888888888
8000000008000008
8000000008000008
8008000008800008
8008888000000088
8000008000000008
8000008000000008
8888888000000888
8000000000000088
8000000000000008
8000008888800008
8000000008000008
8008000008000008
8008000008000008
8888888888888888
