888888888
800000008
888000008
800008888
800000008
908000008
808080808
808080808
888888888