88889888
80000008
80000008
80008888
80800008
80800008
88888888