88888898
80000008
88800008
80000888
80000008
80000008
88888888